XXXXXXXXXXXXXXXXXXXXXXXXXXXXXXXXXXXXXXXXXXXXXXXXXXXXXXXXXXXXXXXXXXXXXXXXXXXXXXXXXXXXXXXXXXXXXXXXXXXXX
X X           X     X   X               X   X     X             X   X   X             X           X X
X XXXXXXX XXX XXX X X XXX X XXXXXXXXXXX X XXX X XXX X XXXXXXXXX X X X X X XXXXX XXXXX X XXXXX XXX X X
X       X   X   X X   X   X   X       X X     X X   X   X   X   X X X X   X     X   X X     X X X   X
XXXXXXX X X XXX X XXX X XXXXX X XXXXX X XXXXXXX X XXXXX X X X XXX X XXXXX X XXXXX X X X XXXXX X XXX X
X   X   X X X X X X X X X   X X     X   X     X     X   X X   X   X     X X   X   X X X X     X     X
X XXX XXXXX X X X X X X XXX X XXXXX XXXXX XXX XXXXX X XXX XXXXX XXXXXXX XXXXX X X XXX X X X XXXXX XXX
X X   X     X X X X   X   X X   X X   X   X X     X X X         X     X       X X   X X X X X   X   X
X X XXX XXXXX X X XXXXXXX X XXX X XXX X XXX XXXXX XXX XXXXXXXXX XXXXX XXXXXXXXX XXX X XXX XXX X XXXXX
X X X   X     X X X       X   X X       X   X   X   X         X X   X         X   X X   X X   X     X
X X X XXX X XXX X X XXXXXXX XXX XXXXXXXXX X X XXXXX X XXXXXXX XXX X X XXX XXX XXXXX XXX X X XXXXXXX X
X X X   X X     X           X   X       X X   X     X X     X   X X X X X   X         X X   X       X
X X XXX X XXXXXXXXXXXXXXX XXX XXX XXXXX X XXXXX XXXXX XXX X XXX X X X X XXX XXXXXXX XXX X XXX XXXXX X
X X   X X             X   X   X   X     X       X   X     X   X   X X   X X     X   X   X X   X     X
X XXX X X XXXXXXXXXXX X XXX XXX XXX XXXXX XXXXXXX XXXXX XXXXXXXXXXX XXX X XXXXX XXXXX XXX X XXX XXXXX
X X   X X X   X     X X X X     X   X   X X     X       X     X   X X X       X     X   X X X X X   X
X X XXX XXX X XXXXX X X X XXXXXXX XXX X X X XXXXX XXXXXXX XXX X X X X XXXXXXX XXXXX XXX X X X X X X X
X   X       X   X   X X         X X   X   X   X     X     X X   X   X   X     X   X   X X X X   X X X
X XXXXX XXXXXXX X XXX XXXXXXXXXXX X XXXXXXXXX X XXXXX XXXXX XXXXXXXXX XXX XXXXXXX XXX X X X XXX X X X
X X   X   X   X X     X           X X       X   X     X           X       X     X   X X X X   X   X X
X X X XXX X XXX XXX XXX XXXXXXXXXXX XXX XXX XXXXX XXXXX XXXXXXX X XXX XXXXXXX X X X X X XXX X XXXXXXX
X   X X X X   X   X     X         X     X X       X     X       X   X   X     X   X X X   X X       X
XXXXX X X XXX XXX XXXXXXXXXXX XXX XXXXXXX XXXXXXXXX XXXXX XXXXXXXXX XXX X XXXXXXXXX X XXX XXXXXXXXX X
X   X X X   X   X   X       X   X           X     X X     X     X   X X X X   X   X X X   X         X
X X X X XXX X XXXXX X XXX X XXXXX XXX XXXXX XXX X XXX XXXXX XXX X XXX X X X X X X X X X XXX XXXXXXX X
X X X X     X X     X X   X     X   X X   X     X X   X   X   X X X   X   X X   X   X X     X     X X
XXX X X XXXXX X XXXXX X XXXXXXX XXX X XXX XXXXXXX X XXX XXXXX X X X X XXXXX XXXXXXXXX XXXXXXX XXXXX X
X   X X   X   X X   X X   X   X   X X   X       X   X   X     X   X X         X         X     X     X
X X X XXX X X X XXX X XXX XXX XXX X XXX X XXX X XXXXX X X XXXXXXX XXXXXXXXXXXXX XXXXXXXXX XXX X XXXXX
X X X   X   X X X   X   X   X     X X X X   X X     X X X X X   X       X       X     X   X   X X   X
X XXXXX XXXXXXX X XXX XXXXX X XXXXX X X XXXXX XXXXX X XXX X X X XXXXXXX X X XXXXX XXX X XXX XXX X XXX
X     X   X     X X   X   X X     X   X   X   X       X   X X X       X X X X   X   X     X   X X   X
XXX XXXXX X XXXXX X XXX X X XXXXX XXXXXXX X XXXXXXX XXX XXX X XXXXXXX X X X X X XXX XXXXXXXXX X XXX X
X   X     X X       X   X X     X X       X       X X   X   X   X X   X   X X X     X X       X   X X
X XXX XXXXX X XXXXXXX XXX XXXXX X X XXXXXXX XXXXX X X XXXXX XXX X X XXX XXXXX XXXXXXX X XXX XXXXX X X
X     X   X X       X X       X X X X   X X X   X X X X       X X X X   X   X X       X   X X     X X
X XXXXX X X XXXXXXX X XXXXXXX X X X X X X X XXX X XXX X X X XXX X X XXXXX X X X XXXXX XXX X X XXXXX X
X   X   X   X   X   X     X     X   X X X       X     X X X X   X X       X   X   X X   X X X   X   X
XXX X X XXXXX XXX XXXXXXX XXXXX XXXXX X XXXXXXXXXXXXX XXX XXX XXX XXXXXXXXXXXXXXX X XXX X XXXXX XXX X
X   X X   X   X   X     X   X   X     X   X         X     X   X         X       X X   X X     X     X
X XXX XXX XXX X XXXXXXX XXX XXXXX XXXXXXX X XXXXXXX XXXXXXX XXXXX XXXXX X XXX XXX X XXX XXX X XXXXX X
X   X   X   X X   X     X X     X   X   X X     X   X     X X     X   X   X   X     X     X X     X X
XXX XXXXXXX X XXX X XXX X XXXXX XXX X X X XXXXX X XXX XXX X X X XXX X XXXXXXXXX XXXXX X XXX XXXXXXX X
X   X   X   X X   X X X       X     X X   X     X X     X X X X     X X           X   X X   X       X
X XXX X X XXX X XXX X XXX XXXXXXXXXXX X XXX XXXXX X XXXXX X XXXXXXXXX X XXXXXXXXXXX XXX X XXX XXXXXXX
X     X   X   X   X X     X     X     X X   X   X   X X   X         X X         X   X   X   X X   X X
XXXXXXXXXXX X XXX X X XXXXX XXX X XXXXX X XXX XXXXXXX X X XXXXXXXXX X XXXXXXXXX X XXX XXXXX X X X X X
X     X     X   X   X     X X     X   X X   X X       X X X     X   X         X X X       X X   X X X
X XXX X XXX XXXXXXXXXXXXX X XXXXXXX XXX XXX X X XXXXX X XXX X XXX XXX XXXXXXXXX X XXXXXXX X XXXXX X X
X   X X X X           X   X   X         X   X   X     X     X     X X   X   X   X     X   X     X X X
X X XXX X XXXXX X XXXXX XXXXX X XXXXXXXXX XXXXXXX XXX XXXXXXXXXXXXX X X X X X XXXXXXX X XXXXXXX X X X
X X     X     X X X     X   X X   X       X     X   X X     X       X X   X X X X     X   X   X X X X
X XXXXXXX XXX X XXX XXXXX XXX XXXXX XXXXXXX XXX X X XXX XXX X XXXXX X XXXXX X X X XXX XXXXX X X X X X
X     X X   X X   X   X     X     X X       X   X X   X X X     X X   X     X X X X   X     X X X   X
XXXXX X X X XXXXX XXX XXXXX XXXXX X X XXXXXXX XXX XXX X X XXXXX X XXXXX X XXX X X XXXXX XXXXX X XXX X
X   X X   X     X   X   X     X X   X X   X   X   X X     X   X       X X X   X X X     X   X X     X
X XXX X XXXXX X X X XXX X XXX X XXXXX X X X XXX XXX XXXXXXX X XXXXX XXX XXX XXX X X XXXXX XXX XXXXXXX
X   X X     X X X X   X X X X   X     X X   X           X   X X     X   X   X   X       X X   X     X
X X X XXXXXXX X X XXX X X X XXX X XXXXX XXXXX XXXXXXXXX X XXX X XXXXX XXX XXX X XXXXXXX X X XXX XXX X
X X X X     X X X X   X X X   X   X   X X   X X       X X   X X     X X       X X     X   X     X X X
X X X X XXX X XXX X XXX X X XXXXXXX XXX X X X X XXXXX X XXX X XXXXXXX X XXXXXXXXX XXX XXXXX XXXXX X X
X X X X   X   X   X X X   X       X   X X X X X X   X X   X X       X   X         X X     X     X X X
X X X X X XXXXX XXX X XXXXX X XXX XXX X X X X X X XXX XXXXX XXXXXXX X XXX XXXXXXXXX XXXXX XXXXX X X X
X X X X X X   X   X       X X   X     X X X X X X   X X     X   X   X   X X             X X   X   X X
X X X XXX X X XXX XXXXXXX XXXXX XXXXXXX XXX X X X X X X XXXXX X X XXXXXXX X X XXXXXXXXXXX X X XXX X X
X X       X X     X   X         X       X   X X X X X   X X   X X     X   X X   X         X X     X X
X XXXXXXXXX XXXXXXXXX X XXXXXXXXX XXXXXXX XXX X X X XXXXX X X X XXXXX X XXXXXXX X XXXXXXXXXXXXXXXXX X
X     X   X X   X     X X X       X   X       X X X       X X X     X X       X   X     X         X X
XXX XXX X X X X X X X X X X XXXXXXX XXX XXXXXXX X XXX XXXXX X XXXXX X XXX XXX XXX X XXX X XXXXXXX X X
X   X   X X X X   X X X   X X       X   X     X X   X       X     X X   X   X   X X   X X X         X
X XXX XXX X X XXXXX XXX XXX XXXXXXX X XXX XXX X X XXXXXXX XXXXXXX XXXXX XXXXXXX X XXX X X XXXXXXXXX X
X   X X     X     X     X   X       X X   X   X X X     X X     X   X   X       X     X X         X X
XXXXX X XXXXXXXXXXX XXXXX XXX XXXXXXX XXXXX XXX X X XXX X XXXXX XXX X XXX XXXXXXXXXXXXX X XXXXXXX X X
X   X X X         X     X X X   X     X   X X   X X   X X         X   X   X     X X     X       X X X
X X X X X XXXXXXX X XXXXX X X X X XXXXX X X X XXXXX XXX XXXXXXXXX XXXXX XXXXX X X X XXXXXXX XXXXX X X
X X   X X       X X X     X   X X X     X   X       X   X   X     X     X   X X   X X   X   X     X X
X XXXXXXXXXXXXX X X X XXXXX XXX X X XXXXX XXXXXXX XXX XXX X X XXXXXXX X X X X XXXXX X X X XXX XXXXX X
X           X   X X X   X X   X X X   X   X     X X   X   X X       X X   X X     X X X   X   X   X X
X XXXXXXXXX X XXX XXXXX X XXX X X X X X XXX XXX XXX XXX XXX XXXXXXX X XXXXX X XXX X XXXXXXX XXX X X X
X     X     X   X       X     X X X X X   X   X   X X   X X X     X X     X X   X X       X X   X   X
XXXXX X XXXXXXX XXXXXXXXX XXXXX X XXX XXXXX X XXX X X XXX X X X XXX XXXXXXX XXXXX XXXXXXX X X XXXXXXX
X X   X X     X X       X X     X     X   X X X X X X     X X X     X     X   X         X X X       X
X X XXX X X X X X XXXXX XXX XXXXXXXXX X X XXX X X X XXXXX X X XXXXXXX XXX XXX X XXXXX XXX X XXXXXXXXX
X   X X   X X X X X   X   X         X X X   X X X X   X   X X X   X   X     X X X   X X   X   X     X
X XXX XXXXX XXX X XXX XXX X XXXXX XXX X XXX X X X X X X XXX X X X XXX XXXXX X X X X XXX XXX X X XXX X
X   X     X     X X     X X     X     X X     X X X X   X X X X X   X   X   X X X X   X X   X X   X X
XXX X XXXXXXXXXXX X XXXXX XXXXXXXXX XXX XXXXXXX X X XXXXX X X X XXX X X X XXX X X XXX X X XXX XXX X X
X   X           X X     X X   X   X   X       X   X       X X X X X X X X X   X   X X   X   X X   X X
X XXX XXXXXXX X X X XXX X X X X X XXX XXXXXXX XXX XXXXXXXXX X X X X XXX X XXX XXX X XXXXXXXXX X XXX X
X X         X X   X   X     X X X X   X     X   X         X X   X X     X   X   X X         X X   X X
X XXXXXXXXXXX XXXXXXXXXXXXXXX X X XXXXX XXX X X XXXXXXXXX X XXXXX XXXXXXXXX XXX X X XXXXXXX X XXX X X
X           X X         X     X X     X   X X X X     X X X   X       X     X   X   X   X   X X   X X
XXXXXXXXXXX X X XXXXXXX X XXXXX XXXXX XXX X XXX XXX X X X XXX X X XXXXX XXXXX XXXXXXX X X XXX X XXX X
X         X X   X X     X   X       X   X X     X   X   X     X X X     X     X     X X   X   X X X X
X XXX XXXXX X XXX X XXXXXXX X XXXXX XXX X XXXXXXX XXXXXXXXXXXXX XXX XXXXXXXXX X XXX X XXXXX X X X X X
X   X       X X   X X     X X X     X X   X   X   X   X   X         X       X X   X X   X   X     X X
XXX XXXXXXXXX X XXX X X X X XXX XXXXX XXXXX XXX X X X X X X XXXXXXXXXXXXX X X X XXX XXX XXXXXXXXX X X
X X X       X   X   X X X X     X   X       X   X   X   X X X   X   X     X X   X   X X X     X   X X
X X XXX XXX XXXXX XXX X XXXXXXXXX X X XXXXX X XXXXXXXXXXX X X X X X X XXXXX XXXXX XXX X X XXX XXXXX X
X       X         X   X           X       X             X     X   X   X           X       X         X
XXXXXXXXXXXXXXXXXXXXXXXXXXXXXXXXXXXXXXXXXXXXXXXXXXXXXXXXXXXXXXXXXXXXXXXXXXXXXXXXXXXXXXXXXXXXXXXXXXXXX
