XXXXXXXXXXXXX
X X       X X
X XXX XXX X X
X     X X   X
XXXXX X XXX X
X   X X     X
X XXX X X X X
X   X     X X
XXX XXXXX X X
X X X X   X X
X X X XXXXX X
X           X
XXXXXXXXXXXXX
